67
8
0 0 0 0 0 0 0 0 0 0 0 0 0 0 0 0 0 0 0 0 0 0 0 0 0 0 0 0 0 0 0 0 0 0 0 0 0 0 0 0 0 0 0 0 0 0 0 0 0 0 0 3 10 0 0 0 0 0 0 0 0 0 0 0 0 0 0 
0 0 0 0 0 0 0 0 0 0 0 0 0 0 0 0 0 0 0 0 0 0 0 0 0 0 0 0 0 0 3 0 0 0 0 0 0 0 0 0 0 0 0 0 0 0 0 0 0 0 0 2 23 0 0 0 0 0 0 0 0 0 0 0 0 0 0 
0 0 0 0 0 0 0 0 0 0 0 0 0 0 0 0 0 0 0 0 0 0 0 0 0 0 0 0 0 10 2 10 10 0 0 0 0 0 0 0 0 0 0 0 0 0 0 3 0 0 10 22 24 0 0 0 0 0 0 0 0 0 0 0 0 0 0 
0 12 0 13 0 0 0 0 0 9 0 0 0 0 0 0 0 0 0 0 0 0 0 6 0 0 0 9 0 22 21 21 23 4 4 0 0 0 0 0 0 0 0 0 0 0 0 2 10 0 22 1 24 0 0 0 0 0 0 0 0 0 0 0 0 0 0 
3 11 0 14 0 0 6 0 10 8 10 10 4 10 0 0 0 0 0 0 0 5 10 7 10 3 10 8 0 25 1 1 1 21 23 4 4 0 0 0 0 0 9 0 5 5 0 22 23 0 25 1 24 0 0 0 0 0 0 0 0 0 0 0 0 0 0 
2 10 5 10 10 10 7 4 22 21 21 21 21 23 0 0 0 0 0 0 0 22 21 21 21 21 21 23 0 25 1 1 1 1 1 21 23 4 4 0 0 10 8 0 22 23 0 25 24 0 25 1 24 0 0 0 0 0 0 0 6 9 3 0 0 0 0 
21 21 21 21 21 21 21 21 1 1 1 1 1 24 0 3 10 10 3 10 10 25 1 1 1 1 1 24 0 25 1 1 1 1 1 1 1 21 23 0 0 22 23 0 25 24 0 25 24 0 25 1 24 0 0 0 0 0 0 0 7 8 2 10 10 10 10 
1 1 1 1 1 1 1 1 1 1 1 1 1 24 0 21 21 21 21 21 21 1 1 1 1 1 1 24 0 25 1 1 1 1 1 1 1 1 24 0 0 25 24 0 25 24 0 25 24 0 25 1 24 0 0 0 0 0 0 0 22 21 21 21 21 21 23 
