84
19
0 0 0 0 0 0 0 0 0 0 0 0 0 0 0 0 0 0 0 0 0 0 0 0 0 0 0 0 0 0 0 0 0 0 0 0 0 0 0 0 0 0 0 0 0 0 0 0 0 0 0 0 0 0 0 0 0 0 0 0 0 0 0 0 0 0 0 0 0 0 0 0 0 0 0 0 0 0 0 0 0 0 0 0 
0 0 0 0 0 0 0 0 0 0 0 0 0 0 0 0 0 0 0 0 0 0 0 0 0 0 0 0 0 0 0 0 0 0 0 0 0 0 0 0 0 0 0 0 0 0 0 0 0 0 0 0 0 0 0 0 0 0 0 0 0 0 0 0 0 0 0 0 0 0 0 0 0 0 0 0 0 0 0 0 0 0 0 0 
0 0 0 0 0 0 0 0 0 0 0 0 0 0 0 0 0 0 0 0 0 0 0 0 0 0 0 0 0 0 0 0 0 0 31 0 0 0 0 0 0 0 0 0 0 0 0 0 0 0 0 0 0 0 0 0 0 0 0 0 0 0 0 0 0 0 0 0 0 0 0 0 0 0 0 0 0 0 0 0 0 0 0 0 
0 0 0 0 0 0 0 0 0 0 0 0 0 0 0 0 0 0 0 0 0 0 0 0 0 0 0 0 0 0 0 0 0 31 0 32 0 0 0 0 0 0 0 0 0 0 0 0 0 0 0 0 0 0 0 0 0 0 0 0 0 0 0 0 0 0 0 0 0 0 0 0 0 0 0 0 0 0 0 0 0 0 0 0 
0 0 0 0 0 0 0 0 0 0 0 0 0 0 0 0 0 0 0 0 0 0 0 0 0 0 0 0 0 0 0 31 30 5 0 9 31 30 30 30 5 0 0 0 0 0 0 0 0 0 0 0 0 0 0 0 0 0 0 0 0 0 0 0 0 0 0 0 0 0 0 0 0 0 31 30 30 32 5 0 0 0 0 0 
0 0 0 0 0 0 0 0 0 0 0 0 0 0 0 0 0 0 0 0 0 0 0 0 0 0 0 0 0 0 0 0 0 7 0 11 0 0 0 0 7 0 0 0 0 0 0 0 0 0 0 0 0 0 0 0 0 0 0 0 0 0 0 0 0 0 0 0 6 31 0 0 0 0 0 0 0 0 7 0 0 0 0 0 
0 0 0 0 0 0 0 0 0 0 6 6 0 0 0 0 0 0 0 0 0 0 0 0 0 0 0 0 0 0 30 0 0 7 0 11 0 0 0 0 7 0 0 0 0 0 0 0 0 0 0 0 0 0 0 0 0 0 0 0 0 0 0 0 0 3 0 31 32 0 0 0 0 0 0 0 0 0 7 0 0 0 0 0 
0 0 0 0 0 0 0 0 24 0 31 32 0 0 0 0 0 2 3 3 2 0 0 0 0 0 0 0 0 0 0 0 0 8 6 10 0 0 0 0 7 0 0 0 0 0 0 0 0 0 0 0 0 0 0 0 0 0 0 0 0 0 0 0 0 31 0 0 0 0 0 0 0 0 0 0 0 0 7 0 0 0 0 0 
0 0 0 0 0 0 0 24 24 0 0 0 0 0 0 0 29 31 30 30 32 0 0 0 0 0 0 0 0 31 30 30 30 30 30 30 32 0 0 0 8 0 0 0 0 0 0 0 0 0 0 0 0 0 0 0 0 3 0 0 0 0 0 31 5 0 0 0 0 0 0 0 0 0 0 0 0 0 7 0 0 0 0 0 
3 0 0 0 0 3 24 24 0 0 0 0 0 0 0 0 0 34 1 1 33 0 0 0 0 0 0 0 0 0 0 0 0 0 0 0 0 0 0 0 31 32 0 0 0 0 0 0 0 2 0 0 0 0 0 31 30 30 32 0 0 0 0 0 7 0 0 0 0 31 32 0 0 0 0 0 0 0 7 0 0 0 0 0 
30 30 30 30 30 30 24 0 0 0 0 0 0 0 0 0 0 0 0 0 0 0 0 0 0 0 0 0 0 0 0 0 0 40 0 0 0 0 0 0 0 0 0 0 0 4 0 0 0 31 32 0 0 0 0 34 1 1 33 0 0 0 0 0 7 0 0 0 31 0 0 0 0 0 0 0 0 0 7 0 0 0 0 0 
0 0 0 0 0 24 24 0 0 0 0 0 0 0 0 0 0 0 0 0 0 0 0 0 0 0 0 0 0 0 0 0 0 0 0 0 0 0 0 0 0 0 0 0 31 32 0 0 0 0 0 0 0 0 0 0 0 0 0 0 0 0 0 0 7 0 0 31 0 0 0 0 0 0 0 0 0 0 7 0 0 0 9 31 
0 0 0 0 0 0 0 0 0 0 4 0 0 0 0 0 0 0 0 0 0 0 0 0 0 0 0 0 0 0 0 0 0 0 0 0 0 0 0 0 4 4 0 0 0 0 0 30 32 0 0 0 0 0 0 0 0 0 0 0 0 0 0 0 7 31 32 0 0 0 0 0 0 0 0 0 0 0 7 0 0 0 11 0 
0 0 0 0 0 0 0 0 31 30 30 30 32 5 0 0 0 0 0 0 0 0 0 0 0 0 0 0 0 0 0 0 0 0 0 0 0 0 0 0 31 32 0 0 0 0 0 0 0 30 30 32 0 0 0 0 0 0 0 0 0 0 31 32 7 0 0 0 0 0 0 0 0 0 0 0 0 0 7 4 0 30 11 0 
3 0 0 0 0 3 0 0 34 1 1 1 33 7 0 0 0 0 0 0 0 0 0 0 0 4 4 0 0 0 0 0 0 31 30 32 5 0 0 0 34 33 0 0 0 0 0 0 0 0 0 0 0 0 0 0 0 0 0 31 32 0 0 0 7 0 0 0 0 0 0 0 0 0 0 0 0 0 7 30 0 0 11 0 
30 30 30 30 30 32 0 0 34 1 1 1 33 7 0 0 0 0 0 0 0 0 0 9 31 30 30 32 0 0 0 0 0 0 0 0 7 0 0 0 34 33 0 0 0 0 0 0 0 0 0 0 0 31 32 0 3 0 0 0 0 0 0 0 7 0 0 0 0 0 0 0 0 0 0 0 0 2 7 0 0 0 11 0 
1 1 1 1 1 33 0 0 34 1 1 1 33 7 0 0 0 0 0 0 3 3 0 11 34 1 1 33 0 0 0 0 0 0 0 0 7 0 0 0 0 0 0 0 0 0 0 0 0 0 0 0 0 0 0 9 30 0 0 0 0 0 0 0 7 3 0 0 0 0 0 0 0 0 0 0 0 30 7 0 0 0 11 0 
1 1 1 1 1 33 0 0 34 1 1 1 33 7 0 0 0 0 0 0 31 32 0 11 34 1 1 33 0 0 0 0 0 0 0 0 7 2 0 0 0 6 0 0 0 0 0 6 0 0 0 0 30 0 0 11 0 0 0 0 0 0 0 0 7 30 0 0 0 0 0 0 0 6 6 6 0 0 7 0 0 0 11 0 
1 1 1 1 1 33 0 0 34 1 1 1 33 8 24 32 0 0 0 0 34 33 0 11 34 1 1 33 0 0 2 31 32 2 0 0 8 31 30 30 30 32 2 0 31 30 30 30 30 32 0 2 2 2 2 10 0 4 4 4 4 4 4 4 7 4 4 4 0 6 2 2 2 30 30 30 2 2 7 6 0 0 10 2 
